RRRRRRRRRRRRRRRRRRRRRRRRRRRRRRRRRRRRRRRRRRRRRRRRRR
R................................................R
R................................................R
R...PPPP.........................................R
R...PPPP.........................................R
R................................................R
R...................RRRRRRRR.....................R
R...................RRRRRRRR.....................R
R...................RRRRRRRR.....................R
R................................................R
R................................................R
R................................................R
R.......PPPP.........................PPPP........R
R.......PPPP.........................PPPP........R
R.......PPPP.........................PPPP........R
R................................................R
R................................................R
R................................................R
R................................................R
R.....................RRRR.......................R
R.....................RRRR.......................R
R.....................RRRR.......................R
R.....................RRRR.......................R
R.....................RRRR.......................R
R................................................R
R................................................R
R...........PPPP.................................R
R...........PPPP.................................R
R...........PPPP.................................R
R................................................R
R................................................R
R................................................R
R................................................R
R................................................R
R................................................R
R......................RR........................R
R......................RR........................R
R......................RR........................R
R......................RR........................R
R......................RR........................R
R................................................R
R................................................R
R................................................R
R................................................R
R.......PPPP..........................PPPP.......R
R.......PPPP..........................PPPP.......R
R................................................R
R................................................R
R................................................R
RRRRRRRRRRRRRRRRRRRRRRRRRRRRRRRRRRRRRRRRRRRRRRRRRR