RPPRPPRPPRPPRPPRPPRPPRPPRPPRPPRPPRPPRPPRPPRPPRPPRPPRPPRPPRPPRPPRPPRPPRPPRPPRPPRPPRPPRPPRPPRPPRPPRPPRPPRPPRPPRPPRPPRPPRPPRPPRP
P.....................................RRRRR.........................................RRR.....................RRRRR...P.P.....P
P......................................RRRRR........................................RRR.....................RRRRR...PPP.....R
R.......................................RRRRR.......................................RRR.....................RRRRR...PPP.....P
P........................................RRRRR.....................................RRR......................RRRRR...PPP.....P
P.........................................RRRRR...................................RRR.......................RRRRR...PPP.....R
R..........................................RRRRR................................RRR.........................RRRRR..PPPP.....P
P............................................RRRRR............................RRR...........................RRRRR.P.P.......P
P..............................................RRRRR........................RRR.............................RRRRR.PPPP......R
R................................................RRRRR....................RRR................................RRRRRPP.P......P
P..................................................RRRRR................RRR...................................RRRRRP........P
P....................................................RRRRR............RRR......................................RRRRR........R
R......................................................RRRRR........RRR.......................................P.RRRRR.......P
P........................................................RRRRR....RRR.........................................PPPRRRRR......P
P..................PPP.....................................RRRRR.RRR........................................PPPPP.RRRRR.....R
R...................PPPPP....................................RRRRRR............................................P...RRRRR....P
P..................PPP....P....................................RRRRR....................................PP.PPPP.....RRRRR...P
P.....................PP...PP................................RRR.RRRRR...........................PP.PPPPPPPPPP......RRRRR...R
R.........................PPPP.............................RRR.....RRRRR.........................PPPPPPP.PPPPP......RRRRR...P
P............................PP..........................RRR.........RRRRR....................PPPPPPPP.P............RRRRR...P
P...........................PPPPPP.P...................RRR.............RRRRR..................PPP.P..................RRRRR..R
R............................PPPPPPPPPP..............RRR.................RRRRR..............PPPPPP...................RRRRR..P
P................................PPP.PPP.P.........RRR.....................RRRRR............PPP....................RRRRR....P
P...................................PPPPPPP......RRR.........................RRRRR.........PPPP...................RRRRR.....R
R......................................PPPP.....RRR...........................RRRRR.......PPPPP..................RRRRR......P
P........................................PPPPP..RRR............................RRRRR.....PPP....................RRRRR.......P
P.........................................P.P.P.RRR.............................RRRRR......PP..................RRRRR........R
R.........................................P.P..RRR.PPPP..........................RRRRR........................RRRRR.........P
P.............................................RRRPPP..P...........................RRRRR......................RRRRR..........P
P...........................................RRR.....PPPPP..........................RRRRR....................RRRRR...........R
R.........................................RRR..........PPP..........................RRRRR..................RRRRR............P
P.......................................RRR...........PPPP...........................RRRRR................RRRRR.............P
P.....................................RRR..............PPPPPR.........................RRRRR..............RRRRR..............R
R...................................RRR...................RRRRR........................RRRRR............RRRRR...............P
P.................................RRR.....................RRRRRP........................RRRRR..........RRRRR................P
P...............................RRR......................RRRRPRR.........................RRRRR........RRRRR.................R
R.............................RRR.........................RRRRRPPP..PP....................RRRRR.......RRRRR.................P
P...........................RRR...........................RRRRR.PPPPP......................RRRRR......RRRRR.................P
P..........................RRR..............................R...PPPPPPPP...................RRRRR......RRRRR.................R
R.........................RRR........................................PPP...................RRRRR......RRRRR.................P
P.......................RRR..........................................PPPPP.................RRRRR......RRRRR.................P
P......................RRR..............................................PP.................RRRRR......RRRRR.................R
R.....................RRR..............................................PPP.................RRRRR......RRRRR.................P
P....................RRR................................................P..................RRRRR.....RRRRR..................P
P....................RRR..................................................PPPPPPPPP.......RRRRR.....RRRRR...................R
R....................RRR..................................................P.PPPP.P.P.....RRRRR....RRRRR.....................P
P.....................RRR.................................................PPPPPPPPPPPP..RRRRR...RRRRR.......................P
P......................RRR..........................................................P..RRRRR..RRRRR.........................R
R.......................RRR........................................................PPPRRRRR.RRRRR...........................P
P........................RRR.PPP....................................................PRRRRRRRRRR.............................P
P.........................RRRPPPP...................................................RRRRRRRRR...............................R
R...........................RRRPPP.................................................RRRRRRRRRP...............................P
P.............................RRRPPP...............................................RRRRRRRRPP...............................P
P...............................RRRP...............................................RRRRRR....PPP....R.......................R
R.................................RRRPP...........................................RRRRRR.....P..P.P.RR......................P
P.................................PPRRR.........................................RRRRRRRR.....P..PPRRRRR.....................P
P.................................PPPPRRR.....................................RRRRR.RRRRR.......PPPRRR......................R
R....................................PPPRRR..................................RRRRR...RRRRR.........PRPPPP...................P
P....................................PPP.PRRR..............................RRRRR......RRRRR........PPPPP....................P
P.........................................P.RRRP.........................RRRRR..........RRRRR.........PP....................R
R.........................................PPPPRRR......................RRRRR.............RRRRR..............................P
P...........................................PPPRRR...................RRRRR................RRRRR.............................P
P............................................PPPRRR................RRRRR...................RRRRR............................R
R............................................PPPPRRR.............RRRRR......................RRRRR...........................P
P................................................PPRRR.........RRRRR.........................RRRRR..........................P
P...............................................PPPPPRRRP.....RRRRR............................RRRRR........................R
R..................................................PPPRRR....RRRRR...............................RRRRR......................P
P...................................................PPRRRPP.RRRRR.................................RRRRR.....................P
P....................................................RRR.PPRRRRR...................................RRRRR....................R
R...................................................RRR.PRRRRR......................................RRRRR...................P
P..................................................RRR..RRRRR.......................................RRRRR...................P
P..................................................RRR.RRRRR.......................................RRRRR....................R
R...................................................RRRRRRR.PP.....................................RRRRR....................P
P....................................................RRRRR.PPP....................................RRRRR.....................P
PRPPRPPRPPRPPRPPRPPRPPRPPRPPRPPRPPRPPRPPRPPRPPRPPRPPRPPRPPRPPRPPRPPRPPRPPRPPRPPRPPRPPRPPRPPRPPRPPRPPRPPRPPRPPRPPRPPRPPRPPRPPR